06 06 06 06 06 06 06 06 06 06 06 06 06 06 06 06 06 06 06 06 06 06 06 06 06 06 06 06 06 06 06 06 06 06 06 06 06 06 06 06 06 06 06 06 06 06 06 06 06 06 06 06 06 06 06 06 06 06 06 06 06 06 06 06 06 06 06 06 06 06 06 06 06 06 06 06 06 06 06 06 06 06 06 06 06 06 06 06 06 06 06 06 06 06 06 06 06 06 04 04
06 06 06 06 06 06 06 06 06 06 06 06 06 06 06 06 06 06 06 06 06 06 06 06 06 06 06 06 06 06 06 06 06 06 06 06 06 06 06 06 06 06 06 06 06 06 06 06 06 06 06 06 06 06 06 06 06 06 06 06 06 06 06 06 06 06 06 06 06 06 06 06 06 06 06 06 06 06 06 06 06 06 06 06 06 06 06 06 06 06 06 06 06 06 06 06 06 06 04 04
06 06 06 06 06 06 06 06 06 06 06 06 06 06 06 06 06 06 06 06 06 06 06 06 06 06 06 06 06 06 06 06 06 06 06 06 06 06 06 06 06 06 06 06 06 06 06 06 06 06 06 06 06 06 06 06 06 06 06 06 06 06 06 06 06 06 06 06 06 06 06 06 06 06 06 06 06 06 06 06 06 06 06 06 06 06 06 06 06 06 06 06 06 06 06 06 06 06 04 04
06 06 06 06 06 06 06 06 06 06 06 06 06 06 06 06 06 06 06 06 06 06 06 06 06 06 06 06 06 06 06 06 06 06 06 06 06 06 06 06 06 06 06 06 06 06 06 06 06 06 06 06 06 06 06 06 06 06 06 06 06 06 06 06 06 06 06 06 06 06 06 06 06 06 06 06 06 06 06 06 06 06 06 06 06 06 06 06 06 06 06 06 06 06 06 06 06 06 04 04
06 06 06 06 06 06 06 06 06 06 06 06 06 06 06 06 06 06 06 06 06 06 06 06 06 06 06 06 06 06 06 06 06 06 06 06 06 06 06 06 06 06 06 06 06 06 06 06 06 06 06 06 06 06 06 06 06 06 06 06 06 06 06 06 06 06 06 06 06 06 06 06 06 06 06 06 06 06 06 06 06 06 06 06 06 06 06 06 06 06 06 06 06 06 06 06 06 06 04 04
06 06 06 06 06 06 06 26 19 19 19 19 19 19 19 19 19 19 19 19 19 19 19 19 19 19 19 19 19 19 19 19 19 19 19 19 19 19 19 19 19 19 19 19 19 19 19 19 19 19 19 19 19 19 19 19 19 19 19 19 19 19 19 19 19 19 19 19 19 19 19 19 23 04 03 03 03 03 03 03 03 28 03 03 03 03 03 03 03 03 03 03 03 06 06 06 06 06 06 06
06 06 06 06 06 06 06 20 04 04 04 04 04 04 04 04 04 04 04 04 04 04 04 04 04 04 04 04 04 04 04 04 04 04 04 04 04 04 04 04 04 04 04 04 04 04 04 04 04 04 04 04 04 04 04 04 04 04 04 04 04 04 04 04 04 04 04 04 04 04 04 04 04 04 03 02 02 02 02 02 03 04 04 04 04 04 04 04 04 04 04 04 03 06 06 06 06 06 06 06
06 06 06 06 06 06 06 20 04 04 04 04 04 04 04 04 04 04 04 04 04 04 04 04 04 04 04 04 04 04 04 04 04 04 04 04 04 04 04 04 04 04 04 04 04 04 04 04 04 04 04 04 04 04 04 04 04 04 04 04 04 04 04 04 04 04 04 04 04 04 04 04 04 04 03 02 02 02 02 02 03 04 04 04 04 04 04 04 04 04 04 04 03 06 06 06 06 06 06 06
06 06 06 06 06 06 06 20 04 04 13 28 28 28 28 28 28 28 28 14 04 04 04 04 04 04 04 04 04 04 04 04 04 04 04 04 04 04 04 04 04 04 04 04 04 04 04 04 04 04 04 04 04 04 04 04 04 04 04 04 04 04 04 04 04 04 04 04 04 04 04 04 04 04 03 02 02 02 02 02 03 04 04 04 04 04 04 04 04 04 04 04 03 06 06 06 06 06 06 06
06 06 06 06 06 06 06 20 04 04 16 01 01 01 01 01 01 01 01 17 04 04 04 04 04 04 04 04 04 04 04 04 04 04 04 04 04 04 04 04 04 04 04 04 04 04 04 04 04 04 04 04 04 04 04 04 04 04 04 04 04 04 04 04 04 04 04 04 04 04 04 04 04 04 03 02 02 02 02 02 03 04 04 04 04 04 04 04 04 04 04 04 03 06 06 06 06 06 06 06
06 06 06 06 06 06 06 03 04 04 16 01 01 01 01 01 01 01 01 17 04 04 04 04 04 04 04 04 04 04 04 04 04 04 04 04 04 04 04 04 04 04 04 04 04 04 04 04 04 04 04 04 04 04 04 04 04 04 04 04 04 04 04 04 04 04 04 04 04 04 04 04 04 04 03 02 02 02 02 02 03 04 04 04 04 04 04 04 04 04 04 04 03 06 06 06 06 06 06 06
06 06 06 06 06 06 06 03 04 04 16 01 01 01 01 01 01 01 01 17 04 04 04 04 04 04 04 04 04 04 04 04 04 04 04 04 04 04 04 04 04 04 04 04 04 04 04 04 04 04 04 04 04 04 04 04 04 04 04 04 04 04 04 04 04 04 04 04 04 04 04 04 04 04 03 03 03 01 03 03 03 04 04 04 04 04 04 04 04 04 04 04 03 06 06 06 06 06 06 06
06 06 06 06 06 06 06 03 04 04 16 01 01 01 01 01 01 01 01 17 04 04 04 04 04 04 04 04 04 04 04 04 04 04 04 04 04 04 04 04 04 04 04 04 04 04 04 04 04 04 04 04 04 04 04 04 04 04 00 00 08 10 10 10 08 00 00 04 04 04 04 04 04 04 04 04 11 01 11 04 04 04 04 04 04 04 04 04 04 04 04 04 03 06 06 06 06 06 06 06
06 06 06 06 06 06 06 03 04 04 12 27 27 03 01 01 03 27 27 15 04 04 04 04 04 04 04 04 04 04 04 04 04 04 04 04 04 04 04 04 04 04 04 04 04 04 04 04 04 04 04 04 04 04 04 04 04 00 00 00 04 04 10 04 00 00 00 00 04 04 04 04 04 04 04 04 11 01 11 04 04 04 04 04 04 04 04 04 04 04 04 04 03 06 06 06 06 06 06 06
06 06 06 06 06 06 06 03 04 04 04 04 04 04 16 17 04 04 04 04 04 04 04 04 04 04 04 04 04 04 04 04 04 04 04 04 04 04 04 04 04 04 04 04 04 04 03 03 03 03 03 03 03 04 04 04 04 00 00 04 04 04 04 04 04 00 00 00 04 04 04 04 04 04 04 04 04 01 04 04 04 04 04 04 04 04 04 04 04 04 04 04 03 06 06 06 06 06 06 06
06 06 06 06 06 06 06 03 04 04 04 04 04 04 16 17 04 04 04 04 04 04 04 04 04 04 04 04 04 04 04 04 04 04 04 04 04 04 04 04 04 04 04 04 04 04 03 02 02 02 02 02 03 04 04 04 04 00 04 04 07 06 06 07 04 04 00 00 04 04 04 04 04 04 04 04 04 01 04 04 04 04 04 04 04 04 04 04 04 04 04 04 03 06 06 06 06 06 06 06
06 06 06 06 06 06 06 03 04 04 04 04 04 04 05 05 04 04 04 04 04 04 04 04 04 04 04 04 04 04 04 04 04 04 04 04 04 04 04 04 04 04 04 04 04 04 03 02 02 02 02 02 03 04 04 04 04 04 04 04 06 06 06 06 04 04 04 04 04 04 04 04 04 04 04 04 04 01 04 04 04 04 04 04 04 04 04 04 04 04 04 04 03 06 06 06 06 06 06 06
06 06 06 06 06 06 06 03 04 04 04 04 04 04 16 17 04 04 04 04 04 04 04 04 04 04 04 04 04 04 04 04 04 04 04 04 04 04 04 04 04 04 04 04 04 04 03 02 02 02 02 02 03 04 04 04 04 04 04 04 06 06 06 06 04 04 04 04 04 04 04 04 04 01 01 01 01 01 04 04 04 04 04 04 04 04 04 04 04 04 04 04 03 06 06 06 06 06 06 06
06 06 06 06 06 06 06 03 04 04 04 04 04 04 06 06 04 04 04 04 04 04 04 04 04 04 04 04 04 04 04 04 04 04 04 04 04 04 04 04 04 04 04 04 04 04 03 03 03 02 03 03 03 04 04 04 04 04 04 04 07 06 06 07 04 04 04 04 04 08 04 04 04 01 04 04 04 04 04 04 04 04 04 04 04 04 04 04 04 04 04 04 03 06 06 06 06 06 06 06
06 06 06 06 06 06 06 03 04 04 04 04 04 04 16 17 04 04 04 04 04 04 04 04 04 04 04 04 04 04 04 04 04 04 04 04 04 04 04 04 04 04 04 04 06 06 04 01 00 01 00 01 04 05 05 04 04 04 04 01 01 01 01 01 01 04 04 08 08 08 04 04 04 01 04 04 04 04 04 04 00 00 04 04 04 04 04 04 04 04 04 04 03 06 06 06 06 06 06 06
06 06 06 06 06 06 06 03 04 04 04 04 04 04 06 06 04 04 04 04 04 04 04 04 04 04 04 04 04 04 04 04 04 04 04 04 04 04 04 04 04 04 04 06 06 07 04 00 01 00 01 00 04 05 05 05 04 04 04 01 01 01 01 01 01 04 04 08 08 08 04 04 04 01 04 04 04 04 04 04 04 04 04 04 04 04 04 04 04 04 04 04 03 06 06 06 06 06 06 06
06 06 06 06 06 06 06 03 04 04 04 04 04 04 16 17 04 04 04 04 04 04 04 04 04 04 04 04 04 04 04 04 04 04 04 04 04 04 04 04 04 04 04 06 06 07 04 01 00 01 00 01 04 05 05 05 04 04 04 04 01 01 01 01 04 04 04 08 08 08 04 04 04 01 01 01 01 01 01 01 04 04 04 04 04 04 04 04 04 04 04 04 03 06 06 06 06 06 06 06
06 06 06 06 06 06 06 03 04 04 04 04 04 04 05 05 04 04 04 04 04 04 04 04 04 04 04 04 04 04 04 04 04 04 04 04 04 04 04 04 04 04 04 04 06 06 04 00 01 00 01 00 04 05 05 04 04 04 04 04 01 01 01 01 04 04 04 08 08 08 04 04 04 04 04 04 04 04 04 01 04 04 04 04 04 04 04 04 04 04 04 04 03 06 06 06 06 06 06 06
06 06 06 06 06 06 06 03 04 04 04 04 04 04 16 17 04 04 04 04 04 04 04 04 04 04 04 04 04 04 04 03 03 03 03 03 03 03 03 03 03 03 03 03 04 04 04 01 00 01 00 01 04 04 04 04 04 04 04 04 04 01 01 04 04 04 04 04 04 04 04 04 04 04 04 00 04 04 04 01 00 04 04 04 04 04 04 04 04 04 04 04 03 06 06 06 06 06 06 06
06 06 06 06 06 06 06 03 04 04 04 04 04 04 16 17 04 04 04 04 04 04 04 04 04 04 04 04 04 04 04 03 06 06 06 06 06 06 06 01 05 05 05 03 04 04 04 04 03 01 03 04 04 04 04 04 04 04 04 04 04 01 01 04 04 04 04 04 04 04 04 04 04 04 00 00 04 04 04 01 00 04 04 04 04 04 04 04 04 04 04 04 03 06 06 06 06 06 06 06
06 06 06 06 06 06 06 03 04 03 01 01 01 01 01 01 01 01 01 01 01 01 03 04 04 04 04 04 04 03 03 03 06 03 03 03 03 03 03 03 03 03 05 03 04 04 04 04 03 01 03 04 06 06 06 04 04 04 04 04 04 01 01 04 04 04 04 04 06 06 06 04 04 00 04 04 04 01 01 01 00 04 04 04 04 04 04 04 04 04 04 04 03 06 06 06 06 06 06 06
06 06 06 06 06 06 06 03 04 03 01 01 01 01 01 01 01 01 01 01 01 01 03 04 04 04 04 04 04 03 03 03 06 03 04 04 04 04 04 04 04 03 05 03 04 04 04 04 03 01 03 04 06 06 06 04 04 04 04 04 04 01 01 04 04 04 04 04 06 06 06 04 04 04 04 04 04 01 04 04 04 04 04 04 04 04 04 04 04 04 04 04 03 06 06 06 06 06 06 06
06 06 06 06 06 06 06 03 04 03 01 01 03 04 04 04 04 04 04 03 01 01 03 04 04 01 01 01 01 01 01 01 01 05 05 05 03 04 04 04 04 03 05 03 04 04 04 04 03 01 03 04 06 06 06 04 09 09 08 10 11 01 01 11 10 08 04 04 06 06 06 04 04 04 04 04 04 01 04 04 04 04 04 04 04 04 04 04 04 04 04 04 03 06 06 06 06 06 06 06
06 06 06 06 06 06 06 03 04 03 01 01 03 04 08 04 08 04 04 03 01 01 01 01 01 01 01 03 03 03 03 03 03 03 03 05 03 04 04 04 04 03 05 03 04 04 01 01 01 01 04 04 04 04 04 04 09 08 08 11 04 01 01 04 11 08 08 04 04 04 04 04 04 04 04 04 04 01 04 04 04 04 04 04 04 04 04 04 04 04 04 04 03 06 06 06 06 06 06 06
06 06 06 06 06 06 06 03 04 03 01 01 03 04 08 08 08 08 04 03 01 01 01 01 01 01 01 03 04 04 04 04 04 04 03 05 03 04 04 04 04 03 05 03 04 04 01 01 01 01 01 01 01 01 01 01 01 01 01 01 01 01 01 01 01 01 01 01 01 01 01 01 01 01 01 01 01 01 01 01 01 04 04 04 04 04 04 04 04 04 04 04 03 06 06 06 06 06 06 06
06 06 06 06 06 06 06 03 04 03 01 01 03 04 04 08 08 04 04 08 08 08 01 03 03 03 03 03 04 04 04 03 03 03 03 05 03 03 03 04 04 03 01 03 03 03 01 01 01 01 03 04 04 04 04 04 09 08 08 11 04 01 01 04 11 08 08 04 04 04 04 04 04 04 04 04 04 04 04 01 01 04 04 04 04 04 04 04 04 04 04 04 03 06 06 06 06 06 06 06
06 06 06 06 06 06 06 03 04 03 01 01 03 03 03 04 08 08 08 08 08 08 06 04 04 04 04 04 00 00 04 03 00 00 00 00 00 00 03 04 04 03 01 01 01 01 01 01 01 01 03 04 05 05 05 04 09 09 08 10 11 01 01 11 10 08 04 04 05 05 05 04 04 04 04 04 04 04 04 04 01 04 04 04 04 04 04 04 04 04 04 04 03 06 06 06 06 06 06 06
06 06 06 06 06 06 06 03 04 01 01 01 01 01 03 03 03 03 03 03 08 08 06 04 04 04 04 04 00 00 04 03 05 03 03 03 03 06 03 04 04 03 03 03 03 03 03 03 03 03 03 04 05 05 05 04 04 04 04 04 04 01 01 04 04 04 04 04 05 05 05 04 04 04 04 04 04 04 04 04 01 04 04 04 04 04 04 04 04 04 04 04 03 06 06 06 06 06 06 06
06 06 06 06 06 06 06 03 04 01 04 01 01 01 01 01 01 01 01 03 08 08 06 04 04 00 00 00 04 04 04 03 00 03 00 00 03 00 03 04 04 04 04 04 04 04 04 04 04 04 04 04 05 05 05 04 04 04 04 04 04 01 01 04 04 04 04 04 05 05 05 04 04 04 04 04 04 04 04 04 01 04 04 04 04 04 04 04 04 04 04 04 03 06 06 06 06 06 06 06
06 06 06 06 06 06 06 03 04 01 01 04 01 04 04 04 04 01 01 03 08 08 01 04 04 04 04 04 04 04 04 03 00 03 06 00 03 00 03 04 04 04 04 04 04 04 04 04 04 04 04 04 04 04 04 04 04 04 04 04 04 01 01 04 04 04 04 04 04 04 04 04 04 04 04 04 04 04 04 04 01 04 04 04 04 04 04 04 04 04 04 04 03 06 06 06 06 06 06 06
06 06 06 06 06 06 06 03 04 01 04 01 01 04 11 11 04 01 01 03 04 04 01 01 01 01 05 04 00 04 04 03 06 11 06 03 11 05 03 04 04 04 04 04 04 04 04 04 04 04 04 04 04 04 04 04 04 04 04 04 04 01 01 04 04 04 04 04 04 04 04 04 04 04 04 04 04 04 04 04 01 04 04 04 04 04 04 04 04 04 04 04 03 06 06 06 06 06 06 06
06 06 06 06 06 06 06 03 04 01 01 04 01 10 10 10 10 01 01 03 04 04 04 04 04 04 05 04 04 04 04 03 00 03 00 00 03 00 03 04 04 04 04 04 04 04 04 04 04 04 04 04 04 04 04 04 04 04 04 04 04 01 01 04 04 04 04 04 04 04 04 04 04 04 04 04 04 04 04 04 01 04 04 04 04 04 04 04 04 04 04 04 03 06 06 06 06 06 06 06
06 06 06 06 06 06 06 03 04 01 01 01 01 01 06 06 01 01 01 03 04 04 04 04 04 04 05 04 04 04 04 03 00 03 03 00 03 00 03 04 04 04 04 04 04 00 00 00 00 00 00 04 04 04 04 04 04 04 04 04 04 01 01 04 04 04 04 04 04 04 04 04 04 04 04 04 04 04 04 04 01 04 04 04 04 04 04 04 04 04 04 04 03 06 06 06 06 06 06 06
06 06 06 06 06 06 06 03 10 07 04 04 01 10 11 11 10 01 03 03 04 04 04 04 01 01 01 10 01 04 04 03 05 03 00 05 03 06 03 04 04 04 04 04 04 00 04 04 04 00 00 04 04 04 04 04 04 04 04 04 01 01 01 01 04 04 04 04 04 04 04 04 04 04 04 04 04 04 04 04 01 04 04 04 04 04 04 04 04 04 04 04 03 06 06 06 06 06 06 06
06 06 06 06 06 06 06 03 07 10 07 10 01 01 05 05 01 01 03 04 04 04 04 04 01 01 08 01 01 04 04 03 00 03 00 03 03 00 03 04 04 04 04 04 04 00 04 04 04 00 00 04 04 04 04 04 04 04 04 04 01 01 01 01 04 04 04 04 04 04 04 04 04 04 04 04 04 04 04 04 01 04 04 04 04 04 04 04 04 04 04 04 03 06 06 06 06 06 06 06
06 06 06 06 06 06 06 03 03 03 03 03 03 03 03 03 03 03 03 04 04 04 04 04 01 11 01 01 01 04 04 03 00 03 06 00 00 05 03 04 04 04 04 04 04 00 00 00 00 00 00 04 04 04 04 04 04 04 04 01 01 01 01 01 01 04 04 04 04 04 04 04 04 04 04 04 04 04 04 00 00 00 00 00 04 04 04 04 04 04 04 04 03 06 06 06 06 06 06 06
06 06 06 06 06 06 06 03 04 04 04 04 04 04 04 04 04 04 04 04 04 04 04 04 01 01 01 01 01 04 04 03 06 03 03 03 03 00 03 04 04 04 04 04 04 04 04 04 04 04 04 04 04 04 04 04 04 04 04 01 01 01 01 01 01 04 04 04 04 04 04 04 04 04 04 04 04 04 00 00 00 00 00 00 04 04 04 04 04 04 04 04 03 06 06 06 06 06 06 06
06 06 06 06 06 06 06 03 04 04 04 04 04 04 04 04 04 04 04 04 04 04 04 04 04 04 04 04 04 04 04 03 00 00 05 06 00 00 03 04 04 04 04 04 04 04 04 04 04 04 04 04 04 04 04 04 04 04 04 04 05 05 05 05 04 04 04 04 04 04 04 04 04 04 04 04 04 00 00 00 10 00 10 00 00 04 04 04 04 04 04 04 03 06 06 06 06 06 06 06
06 06 06 06 06 06 06 03 04 04 04 04 04 04 04 04 04 04 04 04 04 04 04 04 04 04 04 04 04 04 04 03 03 03 03 03 03 03 03 04 04 04 04 04 04 04 04 04 04 04 04 04 04 04 04 04 04 04 04 04 05 05 05 05 04 04 04 04 04 04 04 04 04 04 04 04 04 00 00 10 00 10 00 00 00 04 04 04 04 04 04 04 03 06 06 06 06 06 06 06
06 06 06 06 06 06 06 03 04 04 04 04 04 04 04 04 04 04 04 04 04 04 04 04 04 04 04 04 04 04 04 04 04 04 04 04 04 04 04 04 04 04 04 04 04 04 04 04 04 00 00 04 04 04 04 04 04 04 04 04 05 05 05 05 04 04 04 04 04 01 01 01 01 01 01 01 01 00 00 00 00 00 00 00 00 04 04 04 04 04 04 04 03 06 06 06 06 06 06 06
06 06 06 06 06 06 06 03 04 04 04 04 04 04 04 04 04 04 04 04 04 04 04 04 04 04 04 04 04 04 04 04 04 04 04 04 04 04 04 04 04 04 04 04 04 04 04 04 04 00 00 04 04 04 04 04 04 04 04 04 05 05 05 05 04 04 04 04 04 01 01 01 01 01 01 01 01 00 00 00 00 00 00 00 00 04 04 04 04 04 04 04 03 06 06 06 06 06 06 06
06 06 06 06 06 06 06 03 04 04 04 04 04 04 04 04 04 04 04 04 04 04 04 04 04 04 04 04 04 04 04 04 04 04 04 04 04 04 04 04 04 04 04 04 00 00 00 00 04 04 04 04 04 04 04 04 04 04 04 04 11 01 01 11 04 04 04 00 00 01 01 04 04 04 04 04 04 04 04 04 04 04 04 04 04 04 04 04 04 04 04 04 03 06 06 06 06 06 06 06
06 06 06 06 06 06 06 03 04 04 04 04 04 04 04 04 04 04 04 04 04 04 04 04 04 04 04 04 04 04 04 04 04 04 04 04 04 04 04 04 04 04 04 04 00 00 00 00 04 04 04 04 04 04 04 04 04 04 04 11 11 01 01 11 11 04 04 00 01 01 01 04 04 04 04 04 04 04 04 04 04 04 04 04 04 04 04 04 04 04 04 04 03 06 06 06 06 06 06 06
06 06 06 06 06 06 06 03 04 04 04 04 04 04 04 04 04 04 04 04 04 04 04 04 04 04 04 04 04 04 04 04 04 04 03 03 03 03 03 04 04 04 04 04 00 00 00 00 00 01 01 01 01 01 01 01 04 04 04 04 04 01 01 04 04 04 01 01 01 01 04 04 04 04 04 04 04 04 04 04 04 04 04 04 04 04 04 04 04 04 04 04 03 06 06 06 06 06 06 06
06 06 06 06 06 06 06 03 04 04 04 04 04 04 04 04 04 04 04 04 04 04 04 04 04 04 04 04 04 04 04 04 04 04 03 02 02 02 02 06 06 06 04 04 00 04 00 00 00 04 04 04 04 04 04 01 04 04 04 04 04 01 01 01 01 01 01 01 01 00 04 04 04 04 04 04 04 04 04 04 04 04 04 04 04 04 04 04 04 04 04 04 03 06 06 06 06 06 06 06
06 06 06 06 06 06 06 03 04 04 04 04 04 04 04 04 04 04 04 04 04 04 04 04 04 04 04 04 04 04 04 04 04 04 03 02 02 02 02 07 07 06 04 04 00 07 04 00 00 04 04 04 04 04 04 01 04 04 04 04 04 01 01 01 01 01 01 01 00 00 04 04 04 04 04 04 04 04 04 04 04 04 04 04 04 04 04 04 04 04 04 04 03 06 06 06 06 06 06 06
06 06 06 06 06 06 06 03 04 04 04 04 04 04 04 04 04 04 04 04 04 04 04 04 04 04 04 04 04 04 04 04 04 04 03 02 02 02 02 00 00 00 00 00 00 04 00 00 04 00 00 04 04 04 04 01 01 01 01 01 01 01 01 04 04 04 04 04 04 04 04 04 04 04 04 04 04 04 04 04 04 04 04 04 04 04 04 04 04 04 04 04 03 06 06 06 06 06 06 06
06 06 06 06 06 06 06 03 04 04 04 04 04 04 04 04 04 04 04 04 04 04 04 04 04 04 04 04 04 04 04 04 04 04 03 02 02 02 02 07 07 06 04 04 00 00 00 00 04 00 00 04 04 04 04 04 04 04 04 04 04 04 04 04 04 04 04 04 04 04 04 04 04 04 04 04 04 04 04 04 04 04 04 04 04 04 04 04 04 04 04 04 03 06 06 06 06 06 06 06
06 06 06 06 06 06 06 03 03 03 03 03 03 03 03 03 03 03 03 03 03 03 03 03 03 03 03 03 03 03 03 03 03 03 03 02 02 02 02 06 06 06 04 04 04 04 04 04 04 04 04 04 04 04 04 04 04 04 04 04 04 04 04 04 04 04 04 04 04 04 04 04 04 04 04 04 04 04 04 04 04 04 04 04 04 04 04 04 04 04 04 04 03 06 06 06 06 06 06 06
06 06 06 06 06 06 06 03 04 04 04 04 04 04 04 04 04 04 04 04 04 04 04 04 04 04 04 04 04 04 04 04 04 04 03 03 03 03 03 03 04 04 04 04 04 04 04 04 04 04 04 04 04 04 04 04 04 04 04 04 04 04 04 04 04 04 04 04 04 04 04 04 04 04 04 04 04 04 04 04 04 04 04 04 04 04 04 04 04 04 04 04 03 06 06 06 06 06 06 06
06 06 06 06 06 06 06 03 04 04 04 04 04 04 04 04 04 04 04 04 04 04 04 04 04 04 04 04 04 04 04 04 04 04 04 04 04 04 04 04 04 04 04 04 04 04 04 04 04 04 04 04 04 04 04 04 04 04 04 04 04 04 04 04 04 04 04 04 04 04 04 04 04 04 04 04 04 04 04 04 04 04 04 04 04 04 04 04 04 04 04 04 03 06 06 06 06 06 06 06
06 06 06 06 06 06 06 03 04 11 11 11 08 08 08 08 11 11 11 11 04 04 04 04 04 04 04 04 04 04 04 04 04 04 04 04 04 04 04 04 04 04 04 04 04 04 04 04 04 04 04 04 04 04 04 04 04 04 04 04 04 04 04 04 04 04 04 04 04 04 04 04 04 04 04 04 04 04 04 04 04 04 04 04 04 04 04 04 04 04 04 04 03 06 06 06 06 06 06 06
06 06 06 06 06 06 06 03 04 08 01 01 01 01 01 01 01 01 01 08 04 04 04 04 04 04 04 04 04 04 04 04 04 04 04 04 04 04 04 04 04 04 04 04 04 04 04 04 04 04 04 04 04 04 04 04 04 04 04 04 04 04 04 04 04 04 04 04 04 04 04 04 04 04 04 04 04 04 04 04 04 04 04 04 04 04 04 04 04 04 04 04 03 06 06 06 06 06 06 06
06 06 06 06 06 06 06 03 04 08 01 01 06 01 01 01 05 01 01 08 04 04 04 04 04 04 04 04 04 04 04 04 04 04 04 04 04 04 04 03 03 03 03 03 03 03 03 03 03 03 04 04 04 04 04 04 04 04 04 04 04 04 04 04 04 04 04 04 04 04 04 04 04 04 04 04 04 04 04 04 04 04 04 04 04 04 04 04 04 04 04 04 03 06 06 06 06 06 06 06
06 06 06 06 06 06 06 03 04 01 01 06 01 06 01 05 01 05 01 01 04 04 04 04 04 04 04 04 04 04 04 04 04 04 04 04 04 04 04 03 01 01 01 01 01 01 01 01 01 03 03 03 03 03 03 03 03 03 03 04 04 04 04 04 04 04 03 03 03 03 03 03 03 03 03 04 04 04 04 03 03 03 03 03 03 04 04 04 04 04 04 04 03 06 06 06 06 06 06 06
06 06 06 06 06 06 06 03 04 01 06 01 01 01 05 01 01 01 05 01 04 04 04 04 04 04 04 04 04 04 04 04 04 04 04 04 04 04 04 03 01 01 01 01 00 01 01 01 01 01 06 06 01 05 01 01 01 01 03 04 04 03 03 03 03 03 03 01 01 01 06 01 01 01 03 04 04 04 04 03 01 01 06 01 03 04 04 04 04 04 04 04 03 06 06 06 06 06 06 06
06 06 06 06 06 06 06 03 04 01 01 06 01 01 01 01 01 05 01 01 04 04 04 04 04 04 04 04 04 04 04 04 04 04 04 04 04 04 04 03 01 01 01 00 00 01 01 01 01 03 03 03 03 03 03 03 03 06 03 04 03 03 01 06 01 01 03 01 05 03 03 03 03 06 03 04 04 04 04 03 01 03 03 06 03 03 03 03 03 03 03 04 03 06 06 06 06 06 06 06
06 06 06 06 06 06 06 03 04 01 01 01 06 01 01 01 05 01 01 01 04 04 04 04 04 04 04 04 04 04 04 04 04 04 04 04 04 04 04 03 01 01 01 01 00 01 01 01 01 03 04 04 03 06 01 05 01 01 03 04 03 01 01 03 03 01 03 03 01 03 04 04 03 01 03 04 03 03 03 03 05 03 03 06 01 05 01 01 01 01 03 04 03 06 06 06 06 06 06 06
06 06 06 06 06 06 06 03 04 01 01 01 01 06 01 05 01 01 01 01 04 04 04 04 04 04 04 04 04 04 04 04 04 04 04 04 04 04 04 03 01 01 01 01 00 01 01 01 01 03 04 04 03 06 03 03 03 03 03 03 03 05 03 03 03 05 03 03 01 03 04 03 01 05 03 03 03 01 05 01 01 03 03 03 03 03 03 03 03 01 03 04 03 06 06 06 06 06 06 06
06 06 06 06 06 06 06 03 04 08 01 01 01 01 06 01 01 01 01 08 04 04 04 04 04 04 04 04 04 04 04 04 04 04 04 04 04 04 04 03 01 01 01 00 00 00 01 01 01 03 04 04 03 01 06 01 01 01 05 01 01 01 03 04 03 01 06 01 06 03 04 03 06 01 01 06 01 01 03 03 03 03 04 04 04 04 04 04 04 01 03 04 03 06 06 06 06 06 06 06
06 06 06 06 06 06 06 03 04 08 04 04 04 04 06 04 04 04 04 08 04 04 04 04 04 04 04 04 04 04 04 04 04 04 04 04 04 04 04 03 01 01 01 01 01 01 01 01 01 03 04 04 03 03 03 03 03 03 03 03 03 03 03 04 03 03 03 03 03 03 04 03 03 03 03 03 03 03 03 04 04 03 03 03 03 01 01 01 01 01 03 04 03 06 06 06 06 06 06 06
06 06 06 06 06 06 06 03 04 04 04 04 04 03 06 03 04 04 04 04 04 04 04 04 04 04 04 04 04 04 04 04 04 04 04 04 04 04 04 03 03 03 03 03 03 03 03 03 03 03 04 04 04 04 04 04 04 04 04 04 04 04 04 04 04 04 04 04 04 04 04 04 04 04 04 04 04 04 04 04 03 02 00 00 02 01 00 04 00 00 03 04 03 06 06 06 06 06 06 06
06 06 06 06 06 06 06 03 04 04 04 04 04 03 06 03 04 04 04 04 04 04 04 04 04 04 04 04 04 04 04 04 04 04 04 04 04 04 04 03 03 03 03 03 03 03 03 03 03 03 04 04 04 04 04 04 04 04 04 04 04 04 04 04 04 04 04 04 04 04 04 04 04 04 04 04 04 04 04 04 03 00 01 01 00 01 04 00 04 04 03 04 03 06 06 06 06 06 06 06
06 06 06 06 06 06 06 03 04 04 04 04 04 03 06 03 04 04 04 04 04 04 04 04 04 04 04 04 04 04 04 04 04 04 04 04 04 04 04 03 01 01 01 01 01 01 01 01 01 03 04 04 04 04 04 04 04 04 04 04 04 04 04 04 04 04 04 04 04 04 04 04 04 04 04 04 04 04 04 04 03 02 00 00 02 01 01 01 01 01 03 04 03 06 06 06 06 06 06 06
06 06 06 06 06 06 06 03 04 04 04 04 04 03 06 03 04 04 04 04 04 04 04 04 04 04 04 04 04 04 04 04 04 04 04 04 04 04 04 03 01 01 01 00 00 00 01 01 01 03 04 04 04 04 04 04 04 04 04 04 04 04 04 04 04 04 04 04 04 04 04 04 04 04 04 04 04 04 04 04 04 03 03 03 03 04 04 04 04 01 03 04 03 06 06 06 06 06 06 06
06 06 06 06 06 06 06 03 04 04 04 04 04 03 06 03 04 04 04 04 04 04 04 04 04 04 04 04 04 04 04 04 04 04 04 04 04 04 04 03 01 01 01 01 01 00 01 01 01 03 03 03 03 03 03 03 03 03 03 03 03 03 03 03 03 03 03 03 03 03 03 03 03 03 03 03 03 03 03 03 03 03 03 03 03 03 03 03 03 01 03 04 03 06 06 06 06 06 06 06
06 06 06 06 06 06 06 03 04 04 04 04 04 03 06 03 04 04 04 04 04 04 04 04 04 04 04 04 04 00 00 00 00 11 00 04 04 04 04 03 01 01 01 00 00 00 01 01 01 01 01 01 01 01 01 01 01 01 01 01 01 01 01 01 01 01 01 01 01 01 01 01 01 01 01 01 01 01 01 01 01 01 01 01 01 01 01 01 01 01 03 04 03 06 06 06 06 06 06 06
06 06 06 06 06 06 06 03 04 04 04 04 04 03 06 03 04 04 04 04 04 04 04 04 04 04 04 04 04 11 11 00 11 11 00 00 04 04 04 03 01 01 01 00 01 01 01 01 01 03 03 03 03 03 03 03 03 01 04 04 11 04 11 00 11 00 04 04 04 04 10 10 10 04 04 10 10 10 00 04 10 10 04 04 04 04 04 04 04 01 03 04 03 06 06 06 06 06 06 06
06 06 06 06 06 06 06 03 04 04 04 04 04 03 06 03 04 04 04 04 04 04 04 04 04 04 04 11 00 11 00 04 04 04 11 11 04 04 04 03 01 01 01 00 00 00 01 01 01 03 04 04 04 04 04 04 03 01 04 00 04 11 11 04 04 04 11 11 10 10 04 04 10 10 04 00 04 04 10 10 04 04 04 04 04 04 04 04 04 01 03 04 03 06 06 06 06 06 06 06
06 06 06 06 06 06 06 03 04 04 04 04 04 03 06 03 04 04 04 04 04 04 04 04 04 04 04 04 04 04 04 04 04 04 04 04 04 04 04 03 01 01 01 01 01 01 01 01 01 03 04 04 04 04 04 04 03 01 01 01 01 01 01 01 01 01 01 01 01 01 01 01 01 01 01 01 01 01 01 01 01 01 01 01 01 01 01 01 01 01 03 04 03 06 06 06 06 06 06 06
06 06 06 06 06 06 06 03 04 04 04 04 04 03 06 03 04 04 04 04 04 04 04 04 04 04 04 04 04 04 04 04 04 04 04 04 04 04 04 03 03 03 03 03 03 03 03 03 03 03 04 04 04 04 04 04 03 03 03 03 03 03 03 03 03 03 03 03 03 03 03 03 03 03 03 03 03 03 03 03 03 03 03 03 03 03 03 03 03 03 03 04 03 06 06 06 06 06 06 06
06 06 06 06 06 06 06 03 04 04 04 04 04 03 06 03 04 04 04 04 04 04 04 04 04 04 04 03 03 03 03 03 03 03 03 03 04 04 04 03 03 03 03 03 03 03 03 03 03 03 04 04 04 04 04 04 04 04 04 04 04 04 04 04 04 04 04 04 04 04 04 04 04 04 04 04 04 04 04 04 04 04 04 04 04 04 04 04 04 04 04 04 03 06 06 06 06 06 06 06
06 06 06 06 06 06 06 03 04 04 04 04 04 03 06 03 04 04 04 04 04 04 04 04 04 04 04 03 01 01 01 01 01 01 01 03 04 04 04 03 01 01 01 01 01 01 01 01 01 03 04 04 04 04 04 04 04 04 04 04 04 04 04 04 04 04 04 04 04 04 04 04 04 04 04 04 04 04 04 04 04 04 04 04 04 04 04 04 04 04 04 04 03 06 06 06 06 06 06 06
06 06 06 06 06 06 06 03 04 04 04 04 04 03 06 03 04 04 04 04 04 04 04 04 04 04 04 03 01 01 01 01 01 01 01 03 04 04 04 03 01 01 01 00 00 00 01 01 01 03 04 04 04 04 04 04 04 04 04 04 04 04 04 04 04 04 04 04 04 04 04 04 04 04 04 04 04 04 04 04 04 04 04 04 04 04 04 04 04 04 04 04 03 06 06 06 06 06 06 06
06 06 06 06 06 06 06 03 04 04 04 04 04 03 06 03 04 04 04 04 04 04 04 04 04 04 04 03 01 01 01 01 01 01 01 03 04 04 04 03 01 01 01 01 01 00 01 01 01 03 03 03 03 03 03 03 03 03 03 03 03 03 03 03 03 03 03 03 03 04 04 04 04 04 04 04 04 04 04 04 04 04 04 04 04 04 04 04 04 04 04 04 03 06 06 06 06 06 06 06
06 06 06 06 06 06 06 03 04 04 04 03 03 03 06 03 03 03 03 03 04 04 04 04 04 04 04 03 01 01 01 01 01 01 01 03 04 04 04 03 01 01 01 00 00 00 01 01 01 01 01 01 01 01 01 01 01 01 01 01 01 01 01 01 01 01 01 01 03 04 04 04 04 04 04 04 04 04 04 04 04 04 04 04 04 04 04 04 04 04 04 04 03 06 06 06 06 06 06 06
06 06 06 06 06 06 06 03 04 04 04 03 01 01 01 01 01 01 01 03 04 04 04 04 04 04 04 03 01 01 01 01 01 01 01 03 04 04 04 03 01 01 01 01 01 00 01 01 01 03 03 03 03 03 03 03 03 01 03 03 03 03 01 03 03 03 03 01 03 04 04 04 04 04 04 04 04 04 04 04 04 04 04 04 04 04 04 04 04 04 04 04 03 06 06 06 06 06 06 06
06 06 06 06 06 06 06 03 04 04 04 03 03 03 05 03 06 03 03 03 04 04 04 04 04 04 04 03 01 01 01 01 01 01 01 03 04 04 04 03 01 01 01 00 00 00 01 01 01 03 04 04 04 04 04 07 03 01 03 07 04 03 01 03 07 04 03 01 03 04 04 04 04 04 04 04 04 04 04 04 04 04 04 04 04 04 04 04 04 04 04 04 04 06 06 06 06 06 06 06
06 06 06 06 06 06 06 03 04 04 04 03 05 05 05 03 06 06 06 03 04 04 04 04 04 04 04 03 01 01 01 01 01 01 01 03 04 04 04 03 01 01 01 01 01 01 01 01 01 03 04 04 04 04 04 07 03 03 03 07 04 03 03 03 07 04 03 03 03 04 04 04 04 04 04 04 04 04 04 04 04 04 04 04 04 04 04 04 04 04 04 04 04 06 06 06 06 06 06 06
06 06 06 06 06 06 06 03 04 04 04 03 05 05 05 03 06 06 06 03 04 04 04 04 04 04 04 03 03 03 01 03 01 03 03 03 04 04 04 03 03 03 03 03 03 03 03 03 03 03 04 04 04 04 04 04 04 04 04 04 04 04 04 04 04 04 04 04 04 04 04 04 04 04 04 04 04 04 04 04 04 04 04 04 04 04 04 04 04 04 04 04 04 06 06 06 06 06 06 06
06 06 06 06 06 06 06 03 04 04 04 03 05 05 05 03 06 06 06 03 04 04 04 04 04 04 04 04 04 03 06 03 05 03 04 04 04 04 04 04 04 04 04 04 04 04 04 04 04 04 04 04 04 04 04 04 04 04 04 04 04 04 04 04 04 04 04 04 04 04 04 04 04 04 04 04 04 04 04 04 04 04 04 04 04 04 04 04 04 04 04 04 04 06 06 06 06 06 06 06
06 06 06 06 06 06 06 03 04 04 04 03 05 05 05 03 06 06 06 03 04 04 04 04 04 04 04 04 04 03 06 03 05 03 04 04 04 04 04 04 04 04 04 04 04 04 04 04 04 04 04 04 04 04 04 04 04 04 04 04 04 04 04 04 04 04 04 04 04 04 04 04 04 04 04 04 04 04 04 04 04 04 04 04 04 04 04 04 04 04 04 04 04 06 06 06 06 06 06 06
06 06 06 06 06 06 06 03 04 04 04 03 05 05 03 04 03 06 06 03 04 04 04 04 04 04 04 04 04 03 06 03 05 03 04 04 04 04 04 04 04 04 04 04 04 04 04 04 04 04 04 04 04 04 04 04 04 04 04 04 04 04 04 04 04 04 04 04 04 04 04 04 04 04 04 04 04 04 04 04 04 04 04 04 04 04 04 04 04 04 04 04 04 06 06 06 06 06 06 06
06 06 06 06 06 06 06 03 04 04 04 03 03 05 03 07 03 06 03 03 04 04 04 04 04 04 04 04 04 03 06 03 05 03 04 04 04 04 04 04 04 04 04 04 04 04 04 04 04 04 04 04 04 04 04 04 04 04 04 04 04 04 04 04 04 04 04 04 04 04 04 04 04 04 04 04 04 04 04 04 04 04 04 04 04 04 04 04 04 04 04 04 04 06 06 06 06 06 06 06
06 06 06 06 06 06 06 03 04 04 04 04 03 05 03 11 03 06 03 03 03 03 03 03 03 03 03 03 03 03 06 03 05 03 04 04 04 04 04 04 04 04 04 04 04 04 04 04 04 04 04 04 04 04 04 04 04 04 04 04 04 04 04 04 04 04 04 04 04 04 04 04 04 04 04 04 04 04 04 04 04 04 04 04 04 04 04 04 04 04 04 04 04 06 06 06 06 06 06 06
06 06 06 06 06 06 06 03 04 04 04 04 04 05 03 10 03 06 06 06 06 06 06 06 06 06 06 06 06 06 06 03 05 03 04 04 04 04 04 04 04 04 04 04 04 04 04 04 04 04 04 04 04 04 04 04 04 04 04 04 04 04 04 04 04 04 04 04 04 04 04 04 04 04 04 04 04 04 04 04 04 04 04 04 04 04 04 04 04 04 04 04 04 06 06 06 06 06 06 06
06 06 06 06 06 06 06 03 04 04 04 04 04 05 03 03 03 03 03 03 03 03 03 03 03 03 03 03 03 03 03 03 05 03 04 04 04 04 04 04 04 04 04 04 04 04 04 04 04 04 04 04 04 04 04 04 04 04 04 04 04 04 04 04 04 04 04 04 04 04 04 04 04 04 04 04 04 04 04 04 04 04 04 04 04 04 04 04 04 04 04 04 04 06 06 06 06 06 06 06
06 06 06 06 06 06 06 03 04 04 04 04 04 05 05 05 05 05 05 05 05 05 05 05 05 05 05 05 05 05 05 05 05 03 04 04 04 04 04 04 04 04 04 04 04 04 04 04 04 04 04 04 04 04 04 04 04 04 04 04 04 04 04 04 04 04 04 04 04 04 04 04 04 04 04 04 04 04 04 04 04 04 04 04 04 04 04 04 04 04 04 04 04 06 06 06 06 06 06 06
06 06 06 06 06 06 06 03 04 04 04 04 04 04 04 04 04 04 04 04 04 04 04 04 04 04 04 04 04 04 04 04 04 04 04 04 04 04 04 04 04 04 04 04 04 04 04 04 04 04 04 04 04 04 04 04 04 04 04 04 04 04 04 04 04 04 04 04 04 04 04 04 04 04 04 04 04 04 04 04 04 04 04 04 04 04 04 04 04 04 04 04 04 06 06 06 06 06 06 06
06 06 06 06 06 06 06 06 03 03 03 03 03 03 03 03 03 03 03 03 03 03 03 03 03 03 03 03 03 03 03 03 03 03 03 03 03 03 03 03 03 03 03 03 03 03 03 03 03 03 03 03 03 03 03 03 03 03 03 03 03 03 03 03 03 03 03 03 03 04 04 04 04 04 04 04 04 04 04 04 04 04 04 04 04 04 04 04 04 04 04 04 04 06 06 06 06 06 06 06
06 06 06 06 06 06 06 06 06 06 06 06 06 06 06 06 06 06 06 06 06 06 06 06 06 06 06 06 06 06 06 06 06 06 06 06 06 06 06 06 06 06 06 06 06 06 06 06 06 06 06 06 06 06 06 06 06 06 06 06 06 06 06 06 06 06 06 06 06 06 06 06 06 06 06 06 06 06 06 06 06 06 06 06 06 06 06 06 06 06 06 06 06 06 06 06 06 06 04 04
06 06 06 06 06 06 06 06 06 06 06 06 06 06 06 06 06 06 06 06 06 06 06 06 06 06 06 06 06 06 06 06 06 06 06 06 06 06 06 06 06 06 06 06 06 06 06 06 06 06 06 06 06 06 06 06 06 06 06 06 06 06 06 06 06 06 06 06 06 06 06 06 06 06 06 06 06 06 06 06 06 06 06 06 06 06 06 06 06 06 06 06 06 06 06 06 06 06 04 04
06 06 06 06 06 06 06 06 06 06 06 06 06 06 06 06 06 06 06 06 06 06 06 06 06 06 06 06 06 06 06 06 06 06 06 06 06 06 06 06 06 06 06 06 06 06 06 06 06 06 06 06 06 06 06 06 06 06 06 06 06 06 06 06 06 06 06 06 06 06 06 06 06 06 06 06 06 06 06 06 06 06 06 06 06 06 06 06 06 06 06 06 06 06 06 06 06 06 04 04
06 06 06 06 06 06 06 06 06 06 06 06 06 06 06 06 06 06 06 06 06 06 06 06 06 06 06 06 06 06 06 06 06 06 06 06 06 06 06 06 06 06 06 06 06 06 06 06 06 06 06 06 06 06 06 06 06 06 06 06 06 06 06 06 06 06 06 06 06 06 06 06 06 06 06 06 06 06 06 06 06 06 06 06 06 06 06 06 06 06 06 06 06 06 06 06 06 06 04 04
06 06 06 06 06 06 06 06 06 06 06 06 06 06 06 06 06 06 06 06 06 06 06 06 06 06 06 06 06 06 06 06 06 06 06 06 06 06 06 06 06 06 06 06 06 06 06 06 06 06 06 06 06 06 06 06 06 06 06 06 06 06 06 06 06 06 06 06 06 06 06 06 06 06 06 06 06 06 06 06 06 06 06 06 06 06 06 06 06 06 06 06 06 06 06 06 06 06 04 04
